30 30
14 14 14 14 14 14 14 14 14 14 14 14 14 14 14 14 14 14 14 14 14 14 14 14 14 14 14 14 14 14
14 00 00 00 00 00 00 00 00 00 00 00 00 00 00 00 00 00 00 00 00 00 00 00 00 00 00 00 00 14
14 00 00 00 00 00 00 00 00 00 00 00 00 00 00 00 00 00 00 00 00 00 00 00 00 00 00 00 00 14
14 00 00 00 00 00 00 00 14 14 14 14 14 00 00 00 00 00 00 00 00 00 00 00 00 00 00 00 00 14
14 00 00 00 00 00 00 00 14 00 00 00 14 00 00 00 00 00 14 14 14 14 14 14 14 14 14 00 00 14
14 00 00 00 00 00 00 00 14 00 14 14 14 00 00 00 00 00 14 00 00 00 00 00 00 00 00 00 00 14
14 00 00 00 00 00 14 00 14 14 14 00 00 00 00 00 00 00 14 00 00 00 00 00 00 00 00 00 00 14
14 00 14 00 00 00 00 00 00 00 00 00 00 00 00 00 00 00 14 00 00 14 14 14 14 14 00 00 00 14
14 00 14 00 00 00 14 00 14 00 00 00 00 00 00 00 00 00 14 00 00 14 00 00 00 14 00 00 00 14
14 00 14 00 00 00 14 00 14 00 00 00 00 00 00 14 00 00 14 00 00 14 00 00 00 14 00 00 00 14
14 00 14 14 00 00 00 00 00 00 14 14 14 00 00 14 00 00 14 00 00 14 00 00 00 14 00 00 00 14
14 00 00 00 00 00 00 00 14 00 14 00 00 00 00 14 00 00 14 00 00 14 00 00 00 14 00 00 00 14
14 00 00 00 00 00 00 00 14 00 14 00 14 00 00 14 00 00 14 00 00 14 00 00 00 14 00 00 00 14
14 00 00 00 00 00 00 00 00 00 00 00 00 00 00 14 00 00 14 00 00 14 00 00 00 14 00 00 00 14
14 00 00 14 00 00 00 00 00 00 00 00 00 00 00 14 00 00 14 00 00 14 00 00 00 14 00 00 00 14
14 00 00 14 00 00 00 00 00 00 00 00 00 00 00 14 00 00 14 00 00 00 00 00 00 14 00 00 00 14
14 00 00 14 00 00 00 00 00 00 00 00 00 00 00 14 00 00 14 00 00 00 00 00 00 14 00 00 00 14
14 00 00 14 14 00 00 00 00 00 00 00 00 00 00 14 00 00 14 14 14 14 14 14 14 14 00 00 00 14
14 00 00 14 14 00 00 00 00 00 14 14 14 00 00 14 00 00 00 00 00 00 00 00 00 00 00 00 00 14
14 00 00 14 14 00 00 00 00 00 14 00 14 00 00 14 00 00 00 00 00 00 00 00 00 00 00 00 00 14
14 00 00 00 00 00 00 00 00 00 14 14 14 00 00 14 00 00 00 00 00 00 00 00 00 00 00 00 00 14
14 00 00 00 00 00 14 00 14 00 00 00 00 00 00 00 00 00 00 00 00 00 00 00 00 00 00 00 00 14
14 00 00 00 00 00 00 00 00 00 00 00 00 00 00 00 00 14 14 14 00 00 00 00 00 00 00 00 00 14
14 00 14 14 14 00 14 00 14 00 00 00 00 00 00 00 00 00 00 14 14 14 14 14 00 00 00 00 00 14
14 00 14 00 14 00 14 00 14 00 00 00 00 00 00 00 00 00 00 00 14 14 14 14 00 00 00 00 00 14
14 00 14 00 14 00 00 00 00 00 14 14 14 00 00 00 00 00 00 00 14 14 14 14 00 00 00 00 00 14
14 00 14 14 14 00 00 00 14 00 14 00 00 00 00 00 00 00 00 00 14 14 14 14 00 00 00 00 00 14
14 00 00 00 00 00 00 00 14 00 14 00 14 00 00 00 00 00 00 00 00 00 00 00 00 00 00 00 00 14
14 00 00 00 00 00 00 00 00 00 00 00 00 00 00 00 00 00 00 00 00 00 00 00 00 00 00 00 00 14
14 14 14 14 14 14 14 14 14 14 14 14 14 14 14 14 14 14 14 14 14 14 14 14 14 14 14 14 14 14